_________________________________________mHHHHHm________________________
_________________________________________mBBBBBm________________________
_________________________________________m0----m________________________
_________________________________________m-----m________________________
_________________________________________m--1--m________________________
_________________________________________m-----m________________________
_________________________________________m-----m________________________
_________________________________________bwq-pwd________________________
___________________________________________m-m__________________________
___________________________________________m-m__________________________
___________________________________________m-m_________pwwwwwwwwwwwwwwwq
_________________pwwwwwwwwwwwwwwwq__pwwwwwwd-bwwwwwwq__miHHH4HHHHHHHHHjm
_________________miHHHHHH4HHHHHHjm__miHHHHHj-iHHHHHjm__mIBBBBBBBBBBBBBjm
_________________mIBBBBBBBBBBBBBJm__mIBBBBBJYIBBBBBJm__m3-------------7m
_________________m6--------------m__m---------------m__bwwwwwwq-pwwwwwwd
_________________m-pwwwwq-pwwwwq-m__m-pwwwwq-pwwwwq-m_________m-m_______
_________________m-p____m3m____m-bwwv-m____m-m____m-m_________m-m_______
_________________m-m____bwd____m-iHjm-m____m-m____m-m__pwwwwwwd-bwwwwwwq
_________________m-m_pwq___pwq_m-IBJm-m____m-m____m-m__miHHHHHj-iHHHHHjm
_________________m-m_mHm___mHm_m----m-m____m-m____m-m__mIBBBBBJ-IBBBBBJm
_________________m-bwdBbwwwdBbwzwwd-m-m____m-m____m-m__m6--------------m
_________________m-iHH-HHHHH-HHHHHj-m-m____m-m____m-m__bwwwwwwq-pwwwwwwd
_________________m-IBB-BBBBB-BBBBBJ-m-m____m-m____m-m_________m-m_______
_________________m------------------m-m____m-m____m-m_________m-m_______
_______pwwwwwwwwwd-pwwwwwwwwwwwwwwwwd-m____m-m____m-bwwwwwwwwwd-m_______
_______miHHHHHHHHj-iHHHHHH4HHHHHHHHHj-m____m-m____m-iHH4HHHHHHj-m_______
_______mIBBBBBBBBJ-IBBBBBBBBBBBBBBBBJ-m____m-m____m-IBBBBBBBBBJ-m_______
_______m7-----------------------------m____m-m____m-------------m_______
_______bwwwwwwwwwwwwwwwwwwwwwwwwwwwwwwd____m-m____bwwwwwwwwwwwwwd_______
___________________________________________m-m__________________________
____________________________________pwwwwwwd-bwwwwwwq___________________
____________________________________miHHHHHj-iHHHHHjm___________________
____________________________________mIBBBBBJ-IBBBBBJm___________________
____________________________________m6--------------m___________________
____________________________________m-pwwwwq-pwwwwq-m___________________
____________________________________m-iHHHHj-iHH4Hj-m___________________
____________________________________m-IBBBBJ-IBBBBJ-m___________________
____________________________________m---------------m___________________
____________________________________bwwwwwwq-pwwwwwwd___________________
___________________________________________m-m__________________________
____________________________________pwwwwwwd-bwwwwwwq___________________
____________________________________miHHHHHj-iHHHHHjm___________________
____________________________________mIBBBBBJ-IBBBBBJm___________________
____________________________________m---------------m___________________
________________________________pwwwd-pwwwwq-pwwwwq-m___________________
________________________________mHHHH-iH4HHj-iHHHHj-m___________________
________________________________mBBBB-IBBBBJ-IBBBBJ-m___________________
________________________________m3-----------------5m___________________
________________________________bwwwwwwwwwwwwwwwwwwwd___________________