_________________________________________mHHHHHm________________________
_________________________________________mBBBBBm________________________
_________________________________________m0----m________________________
_________________________________________m-----m________________________
_________________________________________m-----m________________________
_________________________________________m-----m________________________
_________________________________________m-----m________________________
_________________________________________bwq-pwd________________________
___________________________________________m-m__________________________
___________________________________________m-m__________________________
___________________________________________m-m_________pwwwwwwwwwwwwwwwq
_________________pwwwwwwwwwwwwwwwq__pwwwwwwd-bwwwwwwq__miHHHHHHHHHHHHHjm
_________________miHHHHHHHHHHHHHjm__miHHHHHj-iHHHHHjm__mIBBBBBBBBBBBBBjm
_________________mIBBBBBBBBBBBBBJm__mIBBBBBJYIBBBBBJm__m---------------m
_________________m---------------m__m-------1-------m__bwwwwwwq-pwwwwwwd
_________________m-pwwwwq-pwwwwq-m__m-pwwwwq-pwwwwq-m_________m-m_______
_________________m-p____m-m____m-bwwv-m____m-m____m-m_________m-m_______
_________________m-m____bwd____m-iHjm-m____m-m____m-m__pwwwwwwd-bwwwwwwq
_________________m-m___________m-IBJm-m____m-m____m-m__miHHHHHj-iHHHHHjm
_________________m-m_pwq___pwq_m----m-m____m-m____m-m__mIBBBBBJ-IBBBBBJm
_________________m-bwd-bwwwd-bwzwwd-m-m____m-m____m-m__m---------------m
_________________m-iHH-HHHHH-HHHHHj-m-m____m-m____m-m__bwwwwwwq-pwwwwwwd
_________________m-IBB-BBBBB-BBBBBJ-m-m____m-m____m-m_________m-m_______
_________________m------------------m-m____m-m____m-m_________m-m_______
_______pwwwwwwwwwd-pwwwwwwwwwwwwwwwwd-m____m-m____m-dwwwwwwwwwd-m_______
_______miHHHHHHHHj-iHHHHHHHHHHHHHHHHj-m____m-m____m-iHHHHHHHHHj-m_______
_______mIBBBBBBBBJ-IBBBBBBBBBBBBBBBBJ-m____m-m____m-IBBBBBBBBBJ-m_______
_______m------------------------------m____m-m____m-------------m_______
_______bwwwwwwwwwwwwwwwwwwwwwwwwwwwwwwd____m-m____bwwwwwwwwwwwwwd_______
___________________________________________m-m__________________________
____________________________________pwwwwwwd-pwwwwwwq___________________
____________________________________wiHHHHHj-iHHHHHjw___________________
____________________________________wIBBBBBJ-IBBBBBJw___________________
____________________________________w---------------w___________________

