pwwwwwswswwwswq
mHHHHHmHm-l-mlm
mBBBBBmBm-L-mLm
m0----m8m---m3m
m--1--m-bwq-m-m
m-3---m-jHm-m-m
m-----m-JBm-m-m
m-----m--5bwd6m
xwo-cwd-e-HHH-m
m4i-jHi-m-BBB-m
mBI-JBI-m-----m
m------7xwwwwwv
bwwwwwwwdwwwwwd
