__pwwwwwwwwwwq__________________________________
__mHHHHHHHHHHm__________________________________
__mBBBBBBBBBBm__________________________________
__m----------m__________________________________
__m-psq3pssq-m__________________________________
__m-m_xs___m-m__________________________________
__m-m______m-m__________________________________
__m-bzzzzzzd-m__________________________________
__m-HHHHHHHH-m__________________________________
__m-BBBBBBBB-m__________________________________
__m----------mmHHHHHm________pwwwwwwwswwwwwq____
__bwwq-pwwwwwdmBBBBBm________mjHHHHHHmHHHHHHHm__
_____m-m______m0----m________mJBBBBBBmBBBBBBBm__
_____m-m______m-----m________m-------a-------bwq
_____m-m______m--1--m________m-pwwwq-H-pwq-e-jHm
_____m-m______m--33-m________m-m___m-B-m_m-m-JBm
_____m-m______m-----m________m-m___m---m_m-m---m
_____m-bwwwwwwzwo-cwzwwwwwwwwd-bwwwzwwwz_v-a-cwv
_____m-iHHHHHHHHi-jHHHHHHHHHHi-jHHHHi____m-j-jHm
_____m-IBBBBBBBBIYJBBBBBBBBBBI-JBBBBIm___m-J-JBm
_____m-------------------------------m___m-----m
_____bwwwwwwwwwwq-pwwwwwwwwwwwwwwwwwwd___bwwwwwd
________________m-m_____________________________
________________m-m_____________________________
________________m-m_____________________________
________________m-m_____________________________
________________m-m_____________________________
_____pwwwwwwwwwwq-bwwwwwwq______________________
_____mjHHHHHHHHHi-jHHHHHim______________________
_____mJBBBBBBBBBI-JBBBBBIm______________________
_____m-------------------m______________________
_____m-pwwwwwwwwwwwwwwwq-m______________________
_____m-m---------------m-m______________________
_____m-m------pwq------m-bwwwwwwq_______________
_____m-m------mHm------m-jHHHHHim_______________
_____m-m______mBm______m-JBBBBBIm_______________
_____m-m______m-m______m--------m_______________
_____m-m______m-m______xwwwwwwq-m_______________
_____m-m______m-m_____________m-m_______________
_____m-bwwwwwwd-bwwwwwwwwwwwwwd-bwwwwwq_________
_____m-iHHHHHHHHHHHHHHHHHHHHHHj-miHHHjm_________
_____m-IBBBBBBBBBBBBBBBBBBBBBBJ-mIBBBJm_________
_____m--------------------------------m_________
_____bwwwwwwwwwwwwwwwwwwwwwwwwq-pwwwq-m_________
______________________________m-m___m-m_________
______________________________m-m___m-m_________
______________________________m-bwwwd-m_________
______________________________m-iHHHj-m_________
______________________________m-IBBBJ-m_________
______________________________m-------m_________
______________________________bwwwwwwwd_________





