_________pwwwwwswswwwswq
_________mHHHHHmHm-l-mlm
__w______mBBBBBmBm-L-mLm
__w______m0----m-m---m-m
__w______m-----m-bwq-m-m
__w______m--1--m-jHm-m-m
__w______m-----m-JBm-m-m
_-w______m-----m---bwd-m
_-xwwwwwwzwo-cwd-e-HHH-m
_-mHHHHHHHHi-jHi-m-BBB-m
_-mBBBBBBBBI-JBI-m-----m
-------------xsssssv____
bwwwwwwwwwwwzzzd________