__________________________________________________________________________________________________________________
__________________________________________________________________________________________________________________
__________________________________________________________________________________________________________________
_________________________________________________________________________mHHHHHm__________________________________
________________________________________pwwwwwwwwwwwwwwwwwwwwwwwwwwwwwq__mBBBBBm__________________________________
________________________________________mHHHHHHHHHHHHHHHHHHHHHHHHHHHHim__m0----m__________________________________
________________________________________mBBBBBBBBBBBBBBBBBBBBBBBBBBBBIm__m-----m__________________________________
________________________________________m6---------------------------8m__m--1--m__________________________________
________________________________________m-pwwwwwwwwwwwq-pwwwwwwwwwwwq-m__m-----m__________________________________
________________________________________m-m___________m-m___________m-m__m-----m__________________________________
________________________________________m-m___________m-m___________m-m__bwq-pwd__________________________________
________________________________________m-bwwwwwwwwwwwd-xwwwwwwwwwwwv-m____m-m____________________________________
________________________________________m-jHHHHHHHHHHHi-m___________m-m____m-m____________________________________
________________________________________m-JBBBBBBBBBBBI-m___________m-m____m-m_pwwwwwwwwwwwwwwwwwwwwwwwwwwwwwwwwwd
________________________________________m--------------8m___________m-bwwq_m-m_miHHHHHHHHHHHHHHHHHHHHHHHHHHHHHHHjm
________________________________________m-pwwwwwwwwwwwq-m___________m-jHHm_m-m_mIBBBBBBBBBBBBBBBBBBBBBBBBBBBBBBBJm
________________________________________m-m___________m-m___________m-JBBm_m-m_m36------------------------------8m
________________________________________m-bwwwwwwwwwwwd-bwwwwwwwwwwsv---3m_m-m_bwwwwq-bwwwwwwwwwwwwwwwwwwwwwwwwq-m
________________________________________m-jHHHHHHHHHHHi-jHHHHHHHHHHxzwwwwd_m-m______m-iHHHHHHHHHHHHHHHHHHHHHHHHj-m
________________________________________m-JBBBBBBBBBBBI-JBBBBBBBBBBm_______m-m______m-IBBBBBBBBBBBBBBBBBBBBBBBBJ-m
________________________________________m--------------------------m_______m-m______m8---------------------------m
________________________________________m-pwwwwwwwwwwwwwwwwwwwwwwwwd_______m-m______bwwwwwwwwwwwwwwwwwwq-pwwwwwq-m
________________________________________m-m_________pwwwwwwwwwwwwwwwwwwwwwwd-bwwwwwwwwwwwwwwwwwwq______m-m_____m-m
________________________________________m-m_________mHHHHHHHHHHHHHHHHHHHHHHj-iHHHHHHHHHHHHHHHHHHm______m-m_____m-m
________________________________________m-m_________mBBBBBBBBBBBBBBBBBBBBBBJ-IBBBBBBBBBBBBBBBBBBm______m-m_____m-m
________________________________________m-m_________m8-----------------------------------------8m______m-m_____m-m
________________________________________m-m_________m-pwwwwwwwwwwwwwwwwwwwwwwwwwwwwwwwwwwwwwwwq-m______m-m_____m-m
________________________________________m-m_________m-m_______________________________________m-m______m-m_____m-m
________________________________________m-bwwwwwwwwwd-m_______________________________________m-bwwwwwwd-bwwwwwd-m
________________________________________m-HHHHHHHHHHj-m_______________________________________m-iHHHHHHj-iHHHHHj-m
________________________________________m-BBBBBBBBBBJ-m_______________________________________m-IBBBBBBJ-IBBBBBJ-m
________________________________________m-------------m_______________________________________m------------------m
________________________________________bwwwwwwwwwwwq-m_______________________________________m-pwwwwwwwwwwwwwwwwd
____________________________________________________m-bwwwwwwwwwwwwwwwwwwwwwwwwwwwwwwwwwwwwwwwd-m_________________
____________________________________________________m-HHHHHHHHHHHHHHHHHHHHHHHHHHHHHHHHHHHHHHHHH-m_________________
____________________________________________________m-BBBBBBBBBBBBBBBBBBBBBBBBBBBBBBBBBBBBBBBBB-m_________________
____________________________________________________m----------------------7--------------------m_________________
____________________________________________________bwwwwwwwwwwwwwwwwwwwwwwwwwwwwwwwwwwwwwwwwwwwd_________________