pwwwwwswswwwswq
mHHHHHmHm-l-mlm
mBBBBBmBm-L-mLm
m0----m-m---m3m
m--1--m-bwq-m-m
m-3---m-jHm-m-m
m-----m-JBm-m-m
m-----m---bwd-m
xwo-cwd-e-HHH-m
mHi-jHi-m-BBB-m
mBIYJBI-m-----m
m-------xwwwwwv
bwwwwwwwdwwwwwd
