pwwwwwswswwwswq
mHHHHHmHm-l-mlm
mBBBBBmBm-L-mLm
m0----m-m---m3m
m-----m-bwq-m-m
m--1--m-jHm-m-m
m-----m-JBm-m-m
m-----m---bwd-m
xwo-cwd-e-HHH-m
mHi-jHi-m-BBB-m
mBI-JBI-m--3--m
m3------xsssssv
bwwwwwwwzzzzzzd
