__pwwwwwwwwwwq__________________________________
__mHHHHHHHHHHm__________________________________
__mBBBBBBBBBBm__________________________________
__m---------5m__________________________________
__m-psq-pssq-m__________________________________
__m-m_m3m__m-m__________________________________
__m-m_xwv__m-m__________________________________
__m-bwzzzwwd-m__________________________________
__m-HHHHHHHH-m__________________________________
__m-BBBBBBBB-m__________________________________
__m---8------mmHHHHHm________pwwwwwwwswwwwwwwq__
__bwwq-pwwwwwdmBBBBBm________mjHHHHHHmHHHHHHHm__
_____m-m______m0----m________mJBBBBBBmBBBBBBBm__
_____m-m______m-----m________m8------a------8bwq
_____m-m______m--1--m________m-pwwwq-H-pwq-e-jHm
_____m-m______m-----m________m-m___m-B-m_m-m-JBm
_____m-m______m-----m________m-m___m---m_m-m---m
_____m-bwwwwwwzwo-cwzwwwwwwwwd-bwwwzwwwz_v-a-cwv
_____m-iHHHHHHHHi-jHHHHHHHHHHi-jHHHHi____m-j-jHm
_____m-IBBBBBBBBIYJBBBBBBBBBBI-JBBBBIm___m-J-JBm
_____m-----------8-------------------m___m8---3m
_____bwwwwwwwwwwq-pwwwwwwwwwwwwwwwwwwd___bwwwwwd
________________m-m_____________________________
________________m-m_____________________________
________________m-m_____________________________
________________m-m_____________________________
________________m-m_____________________________
_____pwwwwwwwwwwd-bwwwwwwq______________________
_____mjHHHHHHHHHi-jHHHHHim______________________
_____mJBBBBBBBBBI-JBBBBBIm______________________
_____m8------------------m______________________
_____m-pwwwwwwwwwwwwwwwq-m______________________
_____m-m---------------m-m______________________
_____m-bwwwwwwwwq------m-bwwwwwwq_______________
_____m-iHHHHHHHHm------m-jHHHHHim_______________
_____m-IBBBBBBBBm______m-JBBBBBIm_______________
_____m---------3m______m--------m_______________
_____m-pwwwwwwq-m______xwwwwwwq-m_______________
_____m-m______m-m_____________m-m_______________
_____m-bwwwwwwd-bwwwwwwwwwwwwwd-bwwwwwq_________
_____m-iHHHHHHj-iHHHHHHHHHHHHHj-iHHHHHm_________
_____m-IBBBBBBJ-IBBBBBBBBBBBBBJ-IBBBBBm_________
_____m8------------------------------8m_________
_____bwwwwwwwwwwwwwwwwwwwwwwwwq-pwwwq-m_________
______________________________m-m___m-m_________
______________________________m-m___m-m_________
______________________________m-bwwwd-m_________
______________________________m-iHHHj-m_________
______________________________m-IBBBJ-m_________
______________________________m8-----2m_________
______________________________bwwwwwwwd_________
