pwwwwwswswwwswq
mHHHHHmHm-l-mlm
mBBBBBmBm-L-mLm
m0----m8m---m3m
m--1--m-bwq-m-m
m-3---m-jHm-m-m
m-----m-JBm-m-m
m-----m--5bwd6m
xwo-cwdYe-HHH-m
mHi-jHi-m-BBB-m
mBIYJBI-m-----m
m------2xwwwwwv
bwwwwwwwdwwwwwd
