pwwwwwswwwwwwwswwwswwwswwwswswwwwwq
m4HHHHm4HHHHHHmHHHmHHHmHHHmHmHHHHHm
mBBBBBmBBBBBBBmBBBmBBBmBBBmBmBBBBBm
m-----m-------m---m---m---m-m----6m
m-pwwwv-pwwwq-a-e-a-e-a-e-a-m-pwwwv
m-mHH4m-mHHHm-l-m-l-m-l-m-l-m-m4HHm
m-mBBBm-mBBBm-L-m-L-m-L-m-L-m-mBBBm
m-m---m-m---m---m---m---m---m-m---m
m-m-e-m-a-pwzwwwzwq-bwq-bwwwd-n-pwv
m-m-m-m-l-mHHHHHHHm-jHm-jHHHi-m-mHm
m-m-m-m-L-mBBBBBBBm-JBm-JBBBI-m-mBm
m-m-m-m---m-------m---m-------m-m-m
m-m-bwd-cwv-e-cwwwzwo-m-pwwwwwv-m-m
m-m-jHi-jHm-m-jHHHHHi-m-mHHHHHm-m-m
m-m-JBI-JBm-m-JBBBBBI-m-mBBBBBm-m-m
m-m-------m-m5-------2m-m-----m-m-m
m-bwq-cwwwd-m-pwwwwwq-m-a-e-e-a-a-m
m-jHm-jHHHi-m-mHHHHHm-m-l-m-m-l-l-m
m-JBm-JBBBI-m-mBBBBBm-m-L-m-m-L-L-m
m---m-------m-m0----m-m---m-m-----m
xwo-bwo-pwo-m-m-----m-bwq-m-bwwwwwv
mHi-jHi-mHi-m-m--1--m-jHm-m-jHHHHHm
mBI-JBI-mBI-m-m-----m-JBm-m-JBBBBBm
m-------m---m-m-----m---m-m-------m
m-cwswwwv-pwd-bwo-cwd-e-m-m-cwwwq-m
m-jHmHHHm-mHi-jHi-jHi-m-m-m-jHHHm-m
m-JBmBBBm-mBI-JBI-JBI-m-m-m-JBBBm-m
m---m---m-m7---------3m-m-m-----m-m
xwo-a-e-a-m-e-cwwwwwwwv-a-m-e-pwd-m
m4i-l-m-l-m-m-jHHH4HHHm-l-m-m-m4i-m
mBI-L-m-L-m-m-JBBBBBBBm-L-m-m-mBI-m
m-----m---m-m---------m---m-m-m---m
m-cwwwzwwwd-m-cwwwwwq-m-cwd-m-m-cwv
m-jHHH4HHHi-m-jH4HHHm-m-jHi-m-m-jHm
m-JBBBBBBBI-m-JBBBBBm-m-JBI-m-m-JBm
m-----------m-------m-m-----m-m---m
xwo-cwswwwo-m-cwwwq-bwzwwwwwd-xwo-m
mHi-jHmHH4i-m-j4HHm-jHHH4HHHi-mHi-m
mBI-JBmBBBI-m-JBBBm-JBBBBBBBI-mBI-m
m-----m-----m-----m-----------m---m
bwwwwwzwwwwwzwwwwwwwwwwwwwwwwwzwwwd
jHHHHHHHHHHHHHHHHHHHHHHHHHHHHHHHHHi
JBBBBBBBBBBBBBBBBBBBBBBBBBBBBBBBBBI