_________________________________________________________________________________________________
_________________________________________________________________________________________________
_________________________________________________________________________________________________
_________________________________________________________________________mHHHHHm_________________
_________________________________________________________________________mBBBBBm_________________
_________________________________________________________________________m0----m_________________
_________________________________________________________________________m-----m_________________
_________________________________________________________________________m--1--m_________________
_________________________________________________________________________m-----m_________________
_________________________________________________________________________m-----m_________________
_________________________________________________________________________bwq-pwd_________________
___________________________________________________________________________m-m___________________
___________________________________________________________________________m-m___________________
___________________________________________________________________________m-m___________________
___________________________________________________________________________m-m___________________
___________________________________________________________________________m-m___________________
___________________________________________________________________________m-m___________________
___________________________________________________________________________m-m___________________
___________________________________________________________________________m-m___________________
___________________________________________________________________________m-m___________________
___________________________________________________________________________m-m___________________
____________________________________________________pwwwwwwwwwwwwwwwwwwwwwwd-bwwwwwwwwwwwwwwwwwwq
____________________________________________________mBBBBBBBBBBBBBBBBBBBBBBj-iBBBBBBBBBBBBBBBBBBm
____________________________________________________mHHHHHHHHHHHHHHHHHHHHHHJ-IHHHHHHHHHHHHHHHHHHm
____________________________________________________m-----------------------3-------------------m
____________________________________________________m-pwwwwwwwwwwwwwwwwwwwwwwwwwwwwwwwwwwwwwwwq-m
____________________________________________________m-m_______________________________________m-m
____________________________________________________m-m_______________________________________m-m
____________________________________________________m-m_______________________________________m-m
____________________________________________________m-m_______________________________________m-m
____________________________________________________m-m_______________________________________m-m
____________________________________________________m-m_______________________________________m-m
____________________________________________________m-m_______________________________________m-m
____________________________________________________m-bwwwwwwwwwwwwwwwwwwwwwwwwwwwwwwwwwwwwwwwd-m

