pwwwwwwwwwwwwwwwq
mHHHHHHHHHHHHHHHm
m---------------m
m-e------e--cwq-m
m-m-pwwo-a--jHm-m
m-m-mHHi-l----m-m
m-m-l-------e-m-m
m-m----cwwo-m-m-m
m-bwwo-jHHi-m-m-m
m-jHHi------m-m-m
m-------e---m-m-m
xwwwwwo-m-cwd-m-m
mHHHHHi-m-jHi-m-m
m-------m-----m-m
bwwwwwwwzwwwwwzwd
jHHHHHHHHHHHHHHHi